...........
...#@......
...#####...
...........
.......$...
...........