$........
.######..
......#..
.####.#..
.#..#.#..
.#.##.#..
.#....#.@
.######..
.........