###################
#$....#.....#.....#
#####.#.#.###.#.###
#.#...#.#.#...#...#
#.#.###.#.#.#####.#
#.#.#.#.#.#.#.#...#
#.#.#.#.#.#.#.#.###
#.#.#...#.....#...#
#.#.#.###########.#
#.#.#.#.#.....#...#
#.#.#.#.#.###.#.###
#.#.#...#.#...#...#
#.#.#####.#.#####.#
#.........#......@#
###################