#############
#$..#.......#
###.#####.#.#
#.#.....#.#.#
#.#####.#.#.#
#.....#.#.#.#
#.#.###.###.#
#.#........@#
#############