###########
#$...#....#
#....#....#
#.........#
#....#....#
######.####
#....#....#
#....#....#
#.........#
#....#...@#
###########