...............
.#############.
.#...........#.
.#.#########.#.
.#.#.......#.#.
.#.#.#####.#.#.
.#.#.#$..#.#.#.
.#.#.###.#.#.#.
.#.#...#@#.#.#.
.#.#####.#.#.#.
.#.......#.#.#.
.#########.#.#.
...........#.#.
.###########.#.
.............#.