$....................
.....#.....#.........
..#.....#.......#....
....#.......#........
.#.....##......#.....
.....#.....#.....#...
..#......#.......#...
.....#......#........
.#......#......#.....
....#.......#......#.
..#.....#........#...
....................@