$#...........
.#.#########.
.#.#.......#.
.#.#.#####.#.
...#.#...#.#.
####.#.#.#.#.
.....#.#.#.#.
.#####.#.#.#.
.#.....#...#.
.#.#####.###.
.#.......#..@
.#########.#.
............#