.....................
.....................
...$......#......@...
..........#..........
..........#..........
.....#####.######....
..........#..........
..........#..........
..........#..........
####.#####.#########.
..........#..........
..........#..........
..........#..........