$............
#######......
.............
......#######
.............
#######......
.............
......#######
.............
#######......
.............
......#######
............@