###############
#$#.....#.....#
#.###.#.#####.#
#.....#.....#.#
###########.#.#
#.......#...#.#
#.###.#.#.###.#
#...#.#.#.#...#
###.#.#.#.#.#.#
#.#.#.#.#.#.#.#
#.#.#.###.#.#.#
#...#.......#@#
###############